63x26x300x0x1x./NeverLateSalaryMan/img/tileset/BKG01.png
            0a0b0b0b0b0c                                                                                                      
                                                                                                                              
                                                                                                                              
                                                                                                                              
  c0pp                          1a        0a0b0b0b0c              0a0b0c            1a                        1a              
1a                              1b                                                  1b                    e1  1b              
1b0a0b0c                        1c                                                  1b                        1b              
1b                                                                                  1c                        1c              
1b                                                      e0                                                                    
1b                                  e1                                    2sc2                                                
1b                            c1                                          2s                            1a                    
1b                          2s                        0a0b0c    2s        0a0b0c                        1b                    
1b                            0a0b0b0c                1a            e1    2s        e1                  1b                    
1b                                                    1c                                                1c0a0b0c              
1b              0a0b0b0c                                                                                                    1a
1b                                                                                                        e1                1b
1b                                                                                                                          1b
1b                                                                                2s                        1a              1b
1b                                                                                                          1b              1b
1b                                            e0            2s2s2s2s2s                e2                    1b              1b
1b                                                                                                          1b              1b
1b                                                                                                          1b              1b
1b                                        0a0b0b0b0c                              0a0b0b0b0c                1b              1b
1b                                                                                                          1b            gg1b
1bh0h1h1h1h1h1h1h1h1h1h1h1h1h1h1h1h1h1h1h1h1h1h1h1h1h1h1h1h1h1h1h1h1h1h1h1h1h1h1h1h1h1h1h1h1h1h1h1h1h1h1h1h01c              1c
1c0a0b0b0b0b0b0b0b0b0b0b0b0b0b0b0b0b0b0b0b0b0b0b0b0b0b0b0b0b0b0b0b0b0b0b0b0b0b0b0b0b0b0b0b0b0b0b0b0b0b0b0b0b0b0b0b0b0b0b0b0b0c