127x34x300x0x1x./NeverLateSalaryMan/img/tileset/BKG01.png
0a0b0b0b0b0b0b0b0b0b0b0b0b0b0b0b0b0b0b0b0b0b0b0b0b0b0b0b0b0b0b0b0b0b0b0b0b0b0b0b0b0b0b0b0b0b0b0b0b0b0b0b0b0b0b0b0b0b0b0b0b0b0b0b0b0b0b0b0b0b0b0b0b0b0b0b0b0b0b0b0b0b0b0b0b0b0b0b0b0b0b0c                                                                  1a  
1a                                                                      1a                                    1a                                                                                                                                          1b  
1b                                                                      1b                                    1b                                                                                                                                          1b  
1b                                                                      1c                                    1b                                                                                                                                          1b  
1b                                                                                                            1b                                                                                                                                          1b  
1b                                                                                                            1b                                                            2s                                                                            1b  
1b                                                                0a0b0b0c                                    1b                                                                                                                                          1b  
1bc0pp                                    e2                      1a                                          1b              e0                        e2                                                                                                1b  
1c                                                                1b                                          1ck2                                                                                        2s                                              1b  
0a0b0b0b0b0b0b0b0b0c            0a0b0b0b0b0b0c                    1b                                          0a0b0b0b0b0b0b0b0b0b0c                0a0b0b0b0b0c                                          2s                                              1b  
                  1a            1a          1a                    1b                                                              1a                1a        1a                                                                                          1b  
                  1b            1b          1b                    1b                                                              1b                1b        1b                                                                                          1b  
                  1b            1b          1b                    1b                                                              1b                1b        1b            0a0b0b0b0c                                      2s                            1b  
                  1b            1b          1b                    1b                                                              1c                1b        1b            1s      1s                                      2s                            1b  
                  1b            1b          1b                    1b                                                                                1b        1b            0a0b0b0b0c                                      2s                            1b  
                  1b            1b          1b                    1b                              h0h1h1h1h1h1h1h1h1h1h1h1h1h0                      1c        1c                                                                                          1b  
                  1b            1b          1b                    1b                              0a0b0b0b0b0b0b0b0b0b0b0b0b0b0b0b0c                0a0b0b0b0b0c                                                                            2s            1b  
                  1c            1c          1c                    1b                              1a                                                                                                                                                      1b  
0a0b0b0b0b0b0b0b0b0c            0a0b0b0b0b0b0c                    1ch0h1h1h1h1h1h1h1h1h1h1h1h1h1h01c                                                                                                2s                                                    1b  
1a                                                                0a0b0b0b0b0b0b0b0b0b0b0b0b0b0b0b0c                                                                                                2s                    2s2s2s                          1b  
1b                                                                2s                                                                                                                                                                                      1b  
1b                                                                2s                                                                                                                                                                        2s            1b  
1b                                                                2s                                                                e0                                                                                                                    1b  
1b      e0                                                        2s                                                                                                c2                                                                e2                  d1gg
1b                                                    e3      c1  d1                                                                                                                                                                                          
1ck1            2s                                          2s                                                                    0a0b0b0b0b0b0b0b0b0b0c            0a0b0b0b0b0b0b0b0b0b0b0b0c            0a0b0c                      0a0b0b0b0b0b0b0b0b0b0b0c
0a0b0b0b0b0b0b0b0b0b0b0b0b0b0b0b0b0b0b0b0b0b0b0b0b0b0b0b0b0b0b0b0c2s                                                              1a                  1a            1a                      1a                                        1a                1a    
                                                                1a                                                  h0h1h1h1h0    1c                  1b            1b                      1b                                        1b                1b    
                                                                1b                      0a0b0b0b0b0b0c            0a0b0b0b0b0b0b0b0c                  1b            1b                      1b                                        1b                1b    
                                                                1b                      1a          1a            1a                                  1b            1b                      1b                                        1b                1b    
                                                                1b                      1b          1b            1b                                  1b            1b                      1b0a0b0c                    0a0b0c        1b                1b    
                                                                1b                e3    1b          1b            1b                                  1b            1b                      1b      0a0b0c                            1b                1b    
                                                                1c                      1c          1b            1b                                  1b            1b                      1b                                        1b                1b    
                                                                0a0b0b0b0b0b0b0b0b0b0b0b0c          1c            1c                                  1c            1c                      1c                                        1c                1c    