151x56x300x4x4xnobackground
                  1a2a2b2b2b2b2b2b2b2c                                                                                                                                                                                                                3s                                        1a            
                  1b                                                          3s                          3s                          3s                                                                                                                                                        1b            
                  1b                                                        3s  3s          3s          3s  3s        3s            3s  3s                    3s                      3s                              3s        3s          3s                                                  1b            
                  1b                                                          3s                          3s                          3s                                                                                                                                                        1b            
                  1b                                            c2                                                                                                                                                                                    2a2b2b2b2b2c              3s              1b            
                  1b                                                                                                                                                                                                                  e1                  1ae1      3s                          1b            
                  1b          2a2b2b2b2b2b2b2b2b2b2b2b2b2b2b2b2b2b2c                                                                                                            e1          c3                    3s                        3s            1b                                    1b            
                  1b                    1a                        1a      3s                      e2            3s            3s                                                  3s                            3s3s  e0                    3s3s          1c        e2                        e11b            
                  1b                    1b                        1b      3a3b3b3b3b3b3b3b3b3b3b3b3b3b3b3b3b3b3b3c            3a3b3b3b3b3b3b3b3b3b3b3c        3a3b3b3b3b3b3b3b3b3b3c      2a2b2b2b2b2b2b2b2b2b2b2b2b2b2b2b2b2b2b2b2b2b2b2b2b2b2b2b2b2b2b2b2b2b2b2b2b2b2b2b2b2b2b2b2b2b2c        1b            
                  1b                    1b                        1b                                                                                                                      1a                                                                                                    1b            
                  1b                    1b                        1b                                                                                                                      1b                                                                                                    1b            
                  1b                    1b                        1b                                                                                                                      1b                                                                                                    1b            
                  1b                    1b                        1b                                                                                                                      1b                                                                                                    1b            
                  1b                    1b                        1b                                                                                                                      1b                                                                                                    1b            
                  1b                    1b                        1b                                                                                                                      1b                                                                                                    1b            
                  1b                    1b                  e2    1b                                                                                                                      1b                                                            e2                                      1b            
                  1b2a2b2b2b2b2c        1b        2a2b2b2b2b2b2b2c1b                                                                                                                      1b        2a2b2b2b2b2b2b2b2b2b2b2b2b2c        2a2b2b2b2b2b2b2b2b2b2b2b2b2b2b2b2c        2a2b2b2b2b2b2c1b            
                  1b                    1b                        1b                                                                                                                      1b                  1a                                        1a                                      1b            
                  1b                    1b                        1b                                                                                                                      1b                  1b                                        1b                                      1b            
                  1b                    1b                        1b                                                                                                                      1b                  1b                                        1b                                      1b            
                  1b                    1b                        1b                                                                                                                      1b                  1b                                        1b                                      1b            
                  1b                    1b                        1b                                                                                                                      1b              c4  1b                                        1b                                      1b            
                  1b                    1b                        1b                                                                                                                      1b          e2      1c                                        1c          e2                          1b            
                  1b                e2  1c                        1b                                                                                                                      1b2a2b2b2b2b2b2b2b2b2b2b2b2b2b2c          2a2b2b2b2b2b2b2b2b2b2c          2a2b2b2b2b2b2b2b2b2b2b2b2b2c1b            
                  1b        2a2b2b2b2b2b2b2b2b2b2b2b2b2b2c        1b                                                                                                                      1b                                                  1a                                                1b            
                  1b                                              1b                                                                                                                      1b                                                  1b                                                1b            
                  1b                                              1b                                                                                                                      1b                                                  1b                                                1b            
                  1b                                              1b                                                                                                                      1b                                                  1b                                                1b            
                  1b                                              1b                                                                                                                      1b                                                  1b          c5                                    1b            
                  1b                                              1b                                                                                                                      1b                                                  1c                                                1b            
                  1b                                              1b                                                                                                                      1b        2a2b2b2b2b2b2b2b2b2b2b2b2b2b2b2b2c        2a2b2b2b2b2b2b2b2b2b2b2b2b2b2b2b2b2b2b2b2c        1b            
                  1b2a2b2b2b2b2b2b2b2b2c        2a2b2b2b2b2b2b2b2c1b                                                                                                                      1b                            1a                                                                      1b            
                  1b                  1a                          1b                                                                                                                      1b                            1b                                                                      1b            
                  1b                  1b                          1b                                                                                                                      1b                            1b                                                                      1b            
                  1b                  1b                          1b                                                                                                                      1b                            1b                                                                      1b            
                  1b                  1bc1                        1b                                                                                                                      1b                            1b                                                                      1b            
                  1b                  1c                          1b                                                                                                                      1b              e2            1c    e2                                                                1b            
                  1b        3s        2a2b2b2b2b2b2b2b2b2b2c      1b                                                                                                                      1b2a2b2b2b2b2b2b2b2b2c        2a2b2b2b2b2b2b2b2b2b2b2b2b2b2b2c          2a2b2b2b2b2b2b2b2b2b2b2b2b2b2c1b            
                  1b2a2b2b2b2c                                    1b                                                                                                                      1b                  1a                          1a                                                    1b            
                  1b                                              1b                                                                                                                      1b                  1b                          1b                                                    1b            
                  1b                                              1b                                                                                                                      1b                  1b                          1b                                                    1b            
                  1b                                              1b                                                                                                                      1b                  1b                          1b                                                    1b            
                  1b        e2                                    1b                                                                                                                      1b                  1b                          1b                                                    1b            
                  1b      2a2b2b2b2b2b2b2b2c      2a2b2b2b2b2b2b2c1b                                                                                                                      1b                  1b                          1bc6                                                  1b            
                  1b      1a                                      1b                                                                                                                      1b                  1c                          1c                                            e2      1b            
                  1b      1b                                      1b                                                                                                                      1b        2a2b2b2b2b2b2b2b2b2b2b2b2b2b2c        2a2b2b2b2b2b2b2b2b2b2b2b2b2b2b2b2b2b2b2b2b2b2b2b2b2b2c1b            
                  1b      1b                                      1b                                                                                                                      1b                                                                                                    1b            
                  1b      1b                                      1b                                                                                                                      1b                                                                                                    1b            
                  1b      1c                                      1b                                                                                                                      1b                                                                                                    1b            
                  1c2a2b2b2b2b2b2b2b2b2b2b2b2b2b2b2b2b2b2c        1b                                                                                                                      1b                                                                                                    1b            
                                                                  1b                                                                                                                      1b                                                                                                    1c            
                                                                  1b                                                                                                                      1b                                                                                                                  
                                                                  1b                                                                                                                      1b                                                                                                                  
c0                                                                1b                                                                                                                      1b                                                                                                                gg
pp                                    e2                        e11c                                                                                                                      1c                                                                                e2                                
0a0b0b0b0b0b0b0b0b0b0b0b0b0b0b0b0b0b0b0b0b0b0b0b0b0b0b0b0b0b0b0b0b0b                                                                                                                      0a0b0b0b0b0b0b0b0b0b0b0b0b0b0b0b0b0b0b0b0b0b0b0b0b0b0b0b0b0b0b0b0b0b0b0b0b0b0b0b0b0b0b0b0b0b0b0b0b0b0b0b0b0b0b0b0b0c